xxxxxxxxxxxxxxxxxxxxxxxxx
x       xpx             x
x   x   x x    x s s    x
x  sx   x x    x        x
x  sx   x x    x        x
x   x s   x    x     v fx
x  xxxxxxxxxxv xxxxxxxxxx
xx x  x x   x  x   ss  ex
x  x  sts   x  xx xxxxxxx
x  x  xxx      x    s   x
x  s                s v x
xxxxxxxxxxxxxxxxxxxxxxxxx
